rsassa-pss-256 - X25519;rsassa-pss-256 - P-256;rsassa-pss-256 - mlkem512;ed25519 - X25519;ed25519 - P-256;ed25519 - mlkem512;falcon512 - X25519;falcon512 - P-256;falcon512 - mlkem512;sphincssha2128fsimple - X25519;sphincssha2128fsimple - P-256;sphincssha2128fsimple - mlkem512;sphincssha2128ssimple - X25519;sphincssha2128ssimple - P-256;sphincssha2128ssimple - mlkem512
1053,75;940,29;1202,52;1162,78;904,27;1106,90;1292,66;1104,97;1232,45;264,50;220,81;243,98;420,00;400,00;433,33
1014,37;933,68;1158,63;1098,10;930,36;1104,45;1267,98;1060,53;1208,98;249,00;243,70;253,18;440,00;455,56;440,00
1098,44;966,49;1138,28;1114,09;866,19;1091,38;1264,10;1028,85;1221,24;255,81;249,81;273,22;400,00;358,33;457,14
1234,57;997,47;1188,82;1164,39;902,22;1084,43;1276,97;1094,54;1143,49;250,19;227,46;248,83;444,44;410,00;430,00
1153,77;962,23;1147,98;1143,64;957,93;1078,57;1275,35;1049,25;1206,74;259,38;245,04;252,87;390,91;390,91;488,89
1019,49;1018,13;1122,73;1111,94;922,54;1077,02;1283,00;1067,30;1210,45;248,84;248,87;249,79;430,00;381,82;444,44
1055,69;945,45;1202,35;1120,93;999,85;1093,08;1266,41;1108,02;1219,88;249,81;228,08;249,22;455,56;381,82;410,00
1019,23;1049,27;1126,34;1163,46;974,61;1101,14;1272,48;1043,26;1196,17;257,59;243,28;255,91;440,00;390,91;440,00
1020,00;1040,22;1199,19;1156,26;939,19;1027,76;1257,26;1055,33;1174,44;236,81;251,72;261,18;466,67;358,33;381,82
1100,40;991,88;1162,66;1145,11;968,98;1073,52;1278,00;1095,70;1251,73;254,62;228,00;249,23;381,82;372,73;466,67
991,05;1050,55;1171,62;1132,22;984,03;1104,63;1261,12;1072,02;1216,85;263,60;236,11;256,69;440,00;358,33;390,91
985,16;1059,57;1158,89;1157,20;961,74;1078,45;1274,93;1049,53;1210,13;260,08;245,69;248,28;420,00;390,91;381,82
1165,02;1020,15;1187,40;1134,63;965,64;1081,71;1290,35;1062,01;1191,96;250,00;233,46;256,69;420,00;400,00;420,00
1154,47;1063,94;1200,60;1159,92;979,26;1070,36;1260,19;1118,99;1209,86;264,96;227,22;259,92;390,91;363,64;430,00
1163,87;1022,96;1170,40;1132,59;954,30;1087,03;1265,71;1060,49;1213,98;257,98;249,05;255,56;500,00;358,33;466,67
1167,84;1059,18;1158,96;1139,72;970,26;1095,31;1298,82;1025,42;1200,94;238,14;237,64;255,25;381,82;358,33;390,91
1060,67;1048,36;1179,41;1172,12;924,40;1074,25;1328,94;1092,90;1207,13;265,74;242,37;251,17;400,00;381,82;430,00
1010,38;1047,73;1152,92;1074,69;986,83;1113,85;1227,92;1072,18;1190,98;250,00;240,37;255,28;444,44;420,00;410,00
1081,57;1088,33;1133,07;1153,52;982,02;1071,77;1245,81;1082,14;1189,25;257,99;235,29;251,81;390,00;358,33;433,33
1019,09;1132,18;1188,51;1149,51;952,95;1136,84;1285,30;1087,60;1205,08;251,55;235,36;249,03;420,00;372,73;440,00
1012,92;1062,17;1172,83;1125,29;975,82;1089,81;1290,82;1097,25;1217,60;247,71;241,35;259,41;390,91;466,67;466,67
1016,79;1037,97;1156,57;1111,82;1003,88;1063,66;1240,79;1098,37;1212,99;263,53;241,33;252,92;400,00;420,00;433,33
1134,29;1117,98;1162,07;1151,83;977,70;1087,90;1295,14;1102,12;1207,16;246,48;236,67;252,94;430,00;358,33;430,00
1071,43;1045,13;1149,80;1167,37;935,35;1034,98;1272,23;1080,19;1219,37;257,59;239,62;262,45;390,91;381,82;477,78
1063,64;1125,42;1147,54;1098,80;954,60;1091,46;1310,78;1096,30;1234,36;259,52;246,24;253,59;400,00;381,82;410,00
1129,20;1095,49;1172,02;1128,14;969,35;1072,93;1306,15;1137,53;1220,53;240,08;236,43;240,54;390,91;466,67;477,78
1179,01;1038,83;1131,54;1098,18;963,15;1063,74;1242,60;1081,50;1185,71;255,98;235,42;253,67;390,91;420,00;420,00
1100,40;1080,98;1165,99;1065,07;918,57;1063,40;1256,84;1075,81;1203,82;254,27;246,27;259,88;400,00;420,00;372,73
1198,37;986,28;1191,18;1164,39;965,37;1094,27;1323,76;1091,17;1216,06;243,97;235,86;251,55;390,91;400,00;390,91
1066,08;1042,38;1163,40;1119,75;959,97;1083,61;1229,52;1060,73;1202,19;256,20;247,13;262,45;366,67;390,91;420,00
1039,76;1019,32;1136,72;1114,26;958,58;1106,80;1265,51;1089,81;1205,73;253,88;233,33;261,63;377,78;500,00;372,73
1070,75;1031,65;1159,27;1126,45;962,63;1078,19;1322,02;1075,00;1185,63;252,12;235,45;253,08;525,00;400,00;430,00
1173,91;988,81;1162,65;1129,53;971,83;1083,04;1248,37;1070,11;1238,48;252,92;243,96;254,30;430,00;381,82;410,00
1084,86;971,32;1173,98;1127,98;945,17;1103,54;1274,21;1100,76;1215,22;253,14;241,26;257,49;410,00;400,00;430,00
1068,38;1078,60;1196,80;1132,64;985,26;1092,41;1296,46;1014,29;1211,56;262,01;233,70;251,54;358,33;410,00;488,89
1167,70;984,04;1118,75;1125,62;949,35;1058,40;1310,50;1073,86;1231,40;252,33;250,00;247,69;430,00;390,91;363,64
1059,77;989,05;1113,08;1132,16;989,14;1118,27;1280,86;1096,18;1197,36;252,12;228,99;259,90;363,64;390,91;390,91
1073,56;1008,11;1132,42;1112,15;956,79;1112,67;1285,49;1081,13;1203,38;254,29;236,57;252,59;430,00;410,00;440,00
1091,14;1043,75;1213,69;1119,59;923,98;1088,25;1295,72;1097,46;1241,46;248,47;240,00;255,95;381,82;390,91;433,33
1080,59;984,67;1139,04;1130,47;944,32;1119,18;1291,18;1070,91;1201,24;255,47;254,23;256,56;370,00;430,00;400,00
1104,35;994,27;1160,73;1118,52;987,21;1109,34;1286,40;1086,61;1207,94;252,54;237,87;262,50;444,44;390,91;440,00
1179,34;1023,13;1184,26;1168,91;980,46;1151,96;1290,77;1130,12;1218,63;246,54;235,98;241,54;366,67;390,91;430,00
1090,17;1070,83;1150,20;1122,30;928,57;1069,25;1263,65;1076,69;1243,93;247,53;240,30;259,24;477,78;372,73;400,00
1166,67;984,95;1118,77;1160,28;1013,67;1106,90;1226,77;1056,60;1191,87;263,95;244,74;257,51;455,56;430,00;400,00
1206,17;1029,26;1164,34;1146,72;966,00;1110,90;1283,56;1087,80;1217,47;251,91;239,37;250,79;366,67;430,00;600,00
1147,90;1041,76;1107,72;1152,83;951,73;1094,94;1239,22;1093,22;1178,65;247,31;248,09;257,36;381,82;372,73;400,00
1111,02;1007,55;1169,84;1133,13;928,36;1101,92;1262,74;1027,65;1194,07;256,78;245,80;246,59;455,56;381,82;338,46
1163,97;1047,84;1163,09;1099,72;970,59;1145,10;1291,46;1116,33;1205,93;247,86;244,13;244,02;430,00;390,91;372,73
1067,61;992,42;1110,37;1114,50;966,62;1114,99;1303,56;1095,36;1198,59;253,49;244,58;262,15;372,73;363,64;430,00
1092,09;1075,59;1222,09;1125,88;949,18;1086,65;1246,22;1068,37;1210,73;256,33;236,67;256,73;537,50;372,73;390,91
1169,39;1050,00;1166,15;1147,03;992,53;1097,86;1285,19;1079,26;1212,36;250,00;239,10;249,03;390,91;430,00;372,73
1094,39;1032,36;1109,09;1136,09;953,52;1117,76;1264,08;1070,38;1249,63;260,24;243,41;258,57;400,00;400,00;390,91
1036,76;1051,61;1153,60;1119,35;955,27;1132,92;1312,87;1077,86;1224,52;258,65;238,32;263,31;440,00;400,00;420,00
1182,04;1029,88;1191,24;1128,35;938,90;1122,53;1288,45;1065,36;1229,94;249,79;228,78;251,72;455,56;420,00;444,44
1161,04;1011,87;1180,70;1146,30;960,23;1112,88;1275,24;1052,48;1206,21;263,89;231,32;249,81;433,33;400,00;390,91
1157,68;1022,10;1143,48;1117,31;971,62;1053,01;1291,40;1072,64;1213,45;247,08;248,48;253,96;571,43;372,73;430,00
1139,44;1028,26;1130,62;1063,12;1001,25;1082,20;1271,32;1067,88;1194,67;244,89;235,71;255,47;390,91;390,91;400,00
1085,42;971,78;1264,60;1143,86;916,84;1104,48;1261,08;1026,29;1235,32;251,34;246,07;251,98;381,82;381,82;400,00
1123,73;1020,80;1135,00;1103,43;974,47;1011,82;1279,28;1063,43;1187,63;259,07;240,22;261,70;375,00;350,00;466,67
1109,20;1008,70;1195,18;1115,24;997,82;1067,56;1277,51;1091,84;1246,33;237,50;231,14;256,18;466,67;420,00;390,00
1163,75;1054,65;1192,54;1118,18;959,78;1077,89;1286,91;1076,63;1229,64;266,53;238,68;261,60;430,00;341,67;466,67
1047,43;1017,52;1143,25;1129,84;982,28;1079,48;1244,15;1075,80;1181,69;255,38;237,02;256,71;466,67;466,67;390,91
1153,66;976,72;1155,73;1102,12;966,31;1088,11;1257,09;1062,73;1222,33;237,64;247,29;253,91;409,09;430,00;358,33
1135,43;1060,66;1190,17;1154,33;974,11;1095,06;1311,51;1081,91;1222,74;249,61;243,14;253,70;466,67;372,73;477,78
1098,84;1016,43;1136,25;1120,47;965,07;1065,70;1248,46;1064,63;1154,89;260,47;237,41;256,75;414,29;410,00;430,00
1191,74;996,76;1148,81;1098,40;927,73;1112,38;1262,61;1037,10;1212,45;249,75;231,64;247,06;550,00;430,00;372,73
1143,67;1062,89;1154,39;1147,50;993,53;1084,06;1319,41;1114,45;1190,74;252,57;242,00;262,60;390,91;400,00;390,91
1101,73;1067,16;1178,07;1118,03;972,96;1081,66;1283,30;1090,44;1208,03;261,33;236,51;251,35;425,00;400,00;466,67
1202,14;975,84;1172,65;1144,89;950,98;1106,59;1281,74;1071,62;1201,14;246,69;244,06;253,80;420,00;358,33;390,00
1141,20;1058,43;1191,13;1167,64;969,81;1105,81;1322,09;1076,97;1195,71;262,80;238,29;244,62;390,91;366,67;466,67
1007,28;1029,82;1166,47;1136,29;991,85;1100,89;1301,17;1079,92;1189,05;260,94;245,81;265,43;410,00;400,00;430,00
1203,81;989,69;1130,43;1130,40;949,04;1079,32;1283,24;1092,18;1220,85;247,11;241,04;259,30;430,00;390,91;390,00
1241,38;1027,31;1142,58;1135,58;948,36;1094,99;1272,27;1030,00;1185,23;257,83;241,67;238,43;477,78;358,33;358,33
1101,67;980,07;1167,25;1111,89;968,09;1093,35;1247,90;1113,65;1261,21;253,52;247,51;246,56;410,00;333,33;390,91
1087,25;993,55;1139,67;1133,63;991,72;1061,38;1307,31;1119,62;1199,05;243,23;246,18;263,45;430,00;430,00;444,44
1196,33;1018,18;1144,23;1103,66;995,00;1109,80;1291,07;1088,37;1234,09;248,54;227,54;245,24;390,91;381,82;440,00
1168,26;983,27;1122,60;1080,30;954,77;1053,31;1264,65;1051,91;1251,01;257,14;240,22;241,73;410,00;350,00;420,00
1085,29;990,25;1124,90;1163,30;978,17;1079,03;1265,87;1101,53;1260,54;259,14;248,12;264,58;440,00;440,00;422,22
1182,23;1029,12;1159,30;1154,47;982,60;1089,18;1248,01;1096,77;1185,31;232,78;232,10;249,59;358,33;420,00;420,00
1117,51;1036,30;1163,96;1089,39;976,92;1040,08;1281,41;1070,86;1219,55;254,41;247,32;240,56;444,44;390,91;350,00
1204,35;1012,41;1156,40;1122,93;960,61;1058,03;1220,60;1060,26;1244,69;252,29;235,96;259,66;410,00;420,00;350,00
1175,73;1015,08;1131,37;1137,18;983,97;1074,60;1280,16;1076,58;1242,83;252,94;233,33;263,06;628,57;410,00;466,67
1070,31;1049,44;1162,45;1146,90;993,85;1088,53;1274,07;1075,15;1229,76;256,69;239,37;257,83;381,82;390,91;400,00
1120,71;1016,67;1175,90;1119,94;988,65;1117,11;1231,70;1073,09;1217,17;254,02;244,78;248,62;420,00;390,91;410,00
1212,61;1013,36;1110,53;1134,92;935,77;1039,97;1268,51;1076,60;1237,71;246,31;234,46;247,43;400,00;400,00;430,00
1146,50;1050,19;1168,18;1166,62;985,23;1069,53;1272,37;1120,11;1250,48;251,21;244,90;234,98;381,82;372,73;430,00
1195,71;981,85;1099,18;1136,94;962,48;1051,36;1274,71;1066,79;1217,09;254,44;246,28;256,80;420,00;358,33;410,00
1115,79;1014,29;1195,78;1090,14;970,54;1061,11;1218,50;1006,92;1221,29;257,50;238,75;250,00;430,00;488,89;466,67
1217,84;1006,27;1148,64;1104,26;1001,48;1105,92;1280,94;1130,90;1206,34;254,30;234,81;254,07;410,00;444,44;477,78
1160,62;998,89;1111,93;1104,27;953,80;1099,25;1308,18;1102,50;1230,15;250,00;242,54;257,87;477,78;440,00;372,73
1057,94;974,52;1103,45;1111,13;946,54;1083,54;1253,60;1085,55;1246,78;252,92;239,48;264,63;390,91;420,00;390,91
1150,40;1013,18;1196,03;1060,57;937,79;1109,59;1274,61;1055,56;1231,71;257,02;231,00;267,34;455,56;420,00;390,91
1099,58;985,36;1218,18;1116,99;979,22;1078,83;1281,89;1073,33;1213,68;250,00;249,72;251,95;440,00;390,91;422,22
1079,77;970,32;1159,36;1166,67;971,10;1096,31;1275,22;1070,00;1251,16;234,94;240,96;264,62;410,00;341,67;366,67
1193,75;1025,41;1165,87;1075,57;973,12;1086,27;1245,21;1097,78;1246,68;248,86;231,60;258,68;500,00;420,00;400,00
1033,60;1032,10;1098,28;1116,23;934,04;1127,93;1228,82;1056,67;1182,90;259,45;242,54;258,37;400,00;400,00;433,33
1056,12;1035,04;1131,66;1125,69;931,59;1086,43;1308,21;1101,94;1248,67;247,29;245,83;255,10;420,00;400,00;410,00
1203,67;1053,63;1164,84;1189,44;929,07;1108,94;1291,70;1070,06;1246,98;251,45;235,06;245,78;433,33;410,00;430,00
1189,08;1011,44;1173,94;1028,73;967,90;1033,00;1301,60;1063,22;1203,57;256,15;236,79;270,20;455,56;550,00;390,91
1122,89;1011,96;1126,42;1055,49;921,48;1136,00;1219,09;1088,66;1241,00;250,58;248,06;248,57;390,91;345,45;444,44
